11 7
6 4
2 2 2 2 2 2 2 2 2 2 2
2 0 0 0 0 0 0 0 0 0 2
2 0 0 0 0 0 0 0 0 0 2
2 0 0 0 0 1 0 0 0 0 2
2 0 0 0 0 0 0 0 0 0 2
2 0 0 0 0 0 0 0 0 0 2
2 2 2 2 2 2 2 2 2 2 2